11111111111111111111111111111111
10000000000000000C00000000000001
10100101001000001010010000000111
1010010010101010000000000F001011
10001000P000000000000C000E000001
10100C10000000101001000000010101
100010000000000000000C000E000001
10100C10000000101001000000010101
11111111111111111111111111111111